NO textures/wall_no.xpm
SO textures/wall_so.xpm
WE textures/wall_we.xpm
EA textures/wall_ea.xpm

F  112,112,112
C  56,56,56

111111111111111111111111111111111111111111111111
110000000000000000000000000000000000000000010001
100000000000000000000000000000000000000000000001
100000000000000000000000000000000000000000000001
1000000W0000000000000000000000000000000000000001
100000000000000000000000000000000000000000000001
100000000000000000000000000000000000000000000001
100000000000001111111111100000000000000000000001
100000000000011111000000001111110000000000000111
100000000000000111111111111111000000000000000001
100000000000000000000000000000000000000000001111
100000000000000000000000000000000000000000000001
100000000000000000000000000000000000000000000001
100000000000000000000000000000000000000000000001
100000000000000000000000000000000000000000000001
100000000000000000000000000000000000000000000001
111111111111111111111111111111111111111111111111